POS,REF,ALT,TRI
3139,G,T,3
2604,G,C,1
2604,G,T,1
563,G,T,1
713,C,A,1
1954,G,A,13
345,G,T,2
345,G,A,1
4446,C,T,1
2586,G,T,1
3944,C,T,1
3427,G,T,2
435,G,T,1
26,C,T,22
2651,G,T,1
1288,C,T,2
2386,A,G,1
2967,C,T,1
2757,C,T,5
2170,C,T,5
1993,C,T,3
475,G,A,1
2687,C,T,7
2216,G,T,4
2783,A,G,2
2713,T,C,1
3793,C,T,1
2421,G,T,4
85,C,T,1
105,C,T,1
651,T,C,1
2904,G,T,3
824,C,T,1
3829,G,A,1
2512,C,T,2
52,C,T,2
2585,A,G,1
1536,C,T,1
968,C,T,25
1125,G,A,2
1313,G,T,3
3030,C,T,3
869,T,C,2
4299,C,T,7
81,C,T,4
107,C,T,1
126,C,T,4
420,C,T,10
3066,C,T,7
2648,C,T,1
1839,C,A,1
2509,G,C,1
2229,C,T,4
4177,G,T,1
1975,G,A,6
1123,C,T,3
2707,C,T,7
94,C,T,1
1880,A,T,1
3395,C,T,1
540,C,T,2
4089,C,T,2
492,C,T,3
2785,C,T,5
2080,C,T,1
996,A,T,3
3983,C,T,5
318,C,T,1
2520,C,T,3
50,C,T,3
1325,C,T,4
208,G,T,2
798,G,T,3
2029,A,C,1
1073,C,T,1
1345,C,T,2
3438,C,T,2
3572,T,C,1
1006,C,T,1
178,C,T,3
2429,T,C,2
3120,T,C,1
2627,C,A,4
623,C,T,3
966,G,A,1
2627,C,G,3
1877,T,G,2
2278,T,C,1
3991,C,T,2
1152,G,T,2
404,G,A,1
85,C,G,4
2028,A,T,4
577,G,A,19
3392,C,T,3
1949,C,T,2
2409,G,T,1
1818,C,T,2
377,C,T,1
1995,T,C,1
4444,G,A,2
563,G,C,4
4278,G,T,1
332,C,T,2
4226,G,T,16
4369,C,T,3
4310,G,T,2
2314,T,C,2
3859,G,T,1
1231,C,T,2
4258,G,C,2
1329,G,T,1
91,G,C,1
106,C,T,1
3097,C,T,1
2405,C,T,1
925,A,G,1
4309,G,T,2
2934,C,A,2
3242,G,T,1
2507,C,T,2
2703,C,T,1
2209,C,T,2
948,C,T,1
4186,C,T,3
2586,G,C,3
79,A,G,3
414,A,G,1
3508,C,T,1
966,G,T,3
4375,C,T,1
3177,C,T,5
647,T,A,4
3979,A,G,1
2104,G,T,1
775,C,T,2
2293,G,T,3
640,C,T,1
2258,C,T,3
4129,C,T,1
348,C,T,1
3823,C,T,1
1759,G,T,3
4448,G,T,4
3874,T,C,1
103,C,T,2
1664,C,T,1
1800,G,A,1
2697,C,T,1
1276,C,T,1
2661,C,T,5
1996,T,C,2
1122,T,C,1
1948,C,T,1
161,C,T,1
3433,C,T,3
2909,G,T,2
2721,A,G,1
3872,G,T,4
2975,C,T,1
2682,T,C,5
92,A,G,1
1769,A,G,1
4475,C,T,1
3039,C,T,1
1397,G,A,1
205,C,T,1
965,C,T,3
1349,C,A,1
2606,C,T,2
3835,G,T,2
642,A,C,1
3443,C,T,4
3479,G,T,3
924,G,T,1
3442,C,T,1
953,T,C,1
3246,G,T,3
222,C,T,1
3155,C,T,2
88,C,T,1
4342,G,T,1
1380,A,G,1
2293,G,C,2
493,C,T,2
2782,G,T,1
4248,C,T,1
408,C,T,1
376,C,T,1
4337,G,T,1
4407,G,T,1
2989,G,T,1
201,A,G,1
1887,G,T,1
1294,C,T,3
3696,G,T,1
2658,C,T,2
3998,C,T,2
704,T,C,1
2412,G,T,1
3156,A,C,3
463,A,G,1
3474,G,A,8
4086,A,G,2
2362,C,T,1
1771,A,C,1
2488,G,T,1
411,C,T,38
2384,G,T,2
4261,C,T,1
4059,G,T,1
2744,C,T,4
361,T,C,1
4433,G,T,1
2413,C,T,1
4383,G,T,1
3043,G,T,1
109,G,T,1
985,G,C,1
4007,G,T,1
684,G,C,2
2624,C,T,1
2891,C,T,1
1148,T,A,1
228,C,T,1
716,C,T,1
2544,C,T,2
3951,G,T,2
2105,C,T,1
3171,G,T,2
3984,A,G,1
982,G,A,1
4398,G,T,2
2657,C,T,1
359,G,T,2
91,G,T,1
562,T,C,1
1120,C,T,1
3899,G,T,2
4435,C,T,1
3257,C,T,3
1074,C,T,2
479,C,T,3
1750,C,T,1
89,C,T,1
797,G,A,1
1705,C,T,1
1955,C,T,1
2933,C,T,2
351,A,C,1
4151,G,T,1
3861,A,G,1
1199,T,C,1
4180,G,A,1
